NO image.png
SO image copy.png
WE image copy 3.png
EA image copy 2.png

F 0,32,0
C 120,0,16

1111111111111111111111111111111111111111111111111111111111111111
1000000000000000000000000000000000000000000000000110000000000001
10N0000000000000000000000000000000000000000000000110110000000001
1111111111110111111111011111111101111111111111101110110000000011
1000000000010100000001010000000101000000000010000010100001000011
1000001010000000101000000010100000001010000010000010000011100001
1000111011100011101110001110111000111011100010000010100001000011
1000100000100010000010001000001000100000100010000010110000000011
1000100000100010000010001000001000100000100011111000110000000001
1000100000100010000010001000001000100000100011111110000000000001
1000100000100010000010001000001000100000100010000011111110111111
1000100000100010000010001000001000100000100010000010000000000001
1000111111100011111110001111111000111111100010000000000000000001
1100000000000000000000000000000000000000000110000010000000000001
1100000000000000000000000000000000000000000110000010000000000001
1000111111100011111110001111111000111111100011101111111111111111
1000100000100010000010001000001000100000100010000010000000011001
1000100000100010000010001000001000100000100010000010000000011001
1000100000100010000010001000001000100000100010000000000000000001
1000100000100010000010001000001000100000100010000010000000000001
1000100000100010000010001000001000100000100010000010000000000001
1000111011100011101110001110111000111011100010000010000000000001
1000001010000000101000000010100000001010000010000000000000000001
1000000000010100000001010000000101000000000010000010000000011001
1111111111110111111111011111111101111111111110000010000000011001
1000000000000000000000000000000000000000000010000011111111111111
1000000000000000000000000000000000000000000010000010000000000001
1111111111111111111111111111111111111111111110000000000000000001
1111111111111111111111111111111111111111111110000010000000000001
1000000000000000000000000000000000000000000011011111100000000001
1000000000000000000000000000000000000000000000000000100000000001
1000000000000000000000000000000000000000000000000000100000000001
1000000000000000000000000000000000000000000000000000100000000001
1000000000000000000000000000000000000000000000000000100000000001
1000000000000000000000000000000000000000000000000000110000000001
1000000000000000000000000000000000000000000000000000110111111111
