111111111111111111111111111111111111111111111
100000000000000000000000000000000000000000001
10N000000000000000000000000000000000000000001
111111111111011111111101111111110111111111111
100000000001010000000101000000010100000000001
100000101000000010100000001010000000101000001
100011101110001110111000111011100011101110001
100010000010001000001000100000100010000010001
100010000010001000001000100000100010000010001
100010000010001000001000100000100010000010001
100010000010001000001000100000100010000010001
100011111110001111111000111111100011111110001
110000000000000000000000000000000000000000011
110000000000000000000000000000000000000000011
100011111110001111111000111111100011111110001
100010000010001000001000100000100010000010001
100010000010001000001000100000100010000010001
100010000010001000001000100000100010000010001
100010000010001000001000100000100010000010001
100011101110001110111000111011100011101110001
100000101000000010100000001010000000101000001
100000000000000000000000000000000000000000001
111111111111111111111111111111111111111111111