NO assets/north_texture.png
SO assets/south_texture.png
WE assets/west_texture.png
EA assets/east_texture.png

C 36,28,45
F 42,44,60

1111111111111111111111111111111111111111111111111111111111111111
1000000000000000000000000000000000000000000000000110000000000001
1000000000000000000000000000000000000000000000000110110000000001
1111111111110111111111011111111101111111111111101110110000000011
1000000000010100000001010000000101000000000010000010100001000011
1000001010000000101000000010100000001010000010000010000011100001
1000111011100011101110001110111000111011100010000010100001000011
1000100000100010000010001000001000100000100010000010110000000011
1000100000100010000010001000001000100000100011111000110000000001
1000100000100010000010001000001000100000100011111110000000000001
1000100000100010000010001000001000100000100010000011111110111111
1000100000100010000010001000001000100000100010000010000000000001
1000111111100011111110001111111000111111100010000000000000000001
1100000000000000000000000000000000000000000110000010000000000001
1100000000000000000000000000000000000000000110000010000000000001
1000111111100011111110001111111000111111100011101111111111111111
1000100000100010000010001000001000100000100010000010000000011001
1000100000100010000010001000001000100000100010000010000000011001
1000100000100010000010001000001000100000100010000000000000000001
1000100000100010000010001000001000100000100010000010000000000001
1000100000100010000010001000001000100000100010000010000000000001
1000111011100011101110001110111000111011100010000010000000000001
1000001010000000101000000010100000001010000010000000000000000001
1000000000010100000001010000000101000000000010000010000000011001
1111111111110111111111011111111101111111111110000010000000011001
1000000000000000000000000000000000000000000010000011111111111111
1000000000000000000000000000000000000000000010000010000000000001
1111111111111111111111111111111111111111111110000000000000000001
1000100000000000000000000000000011111111111110000010000000000001
1000000000000000000000000000000010000000000111011111100000000001
1000100000000000000000000000000010000000000110001111100000000001
1000111111111111111111111110011111110011101110001000100000000001
1000100000000001100000000010010000010010000000001000100000000001
1100100000000000100000000011111000111110000000001000100000000001
1100100000000000000000000010001101100010000000001000110000000001
1100100000000000100000000010001000100010000000000000110111111111
1000100000000001100000000111011000110110011111111111100011100111
1000111111011111111111101110000000000010010000000000100010000001
1000000000000010000001000110000111000010010000000000100000000001
1000000000000000000001000110001111100010010000000000100010000001
1000000000000010000001000110011010110011111011111111100010000001
1101111111111111111111000100010010010001000000000000000010000001
1100000000000000100000000000011111110000000000000000000000000001
1100000000000000100001000100011101110001000000000000000010000001
1110000000000000100001101110001111100011111011111110000010000001
1110000000000000100001000110001010100010000001100011100010000001
1111111111111111111111000010000000000010000001100000100000000001
                     1000011011000110111110000000000100010000001
                     1000010001000100000010000000000100011111111
                     1111110001101100000011111111111110111111111
                        1000001000100000010000000000000000000001
                        1000001000100000000000000000000000000001
                        1000001000100000010000000000000000000001
                        1000001000100000011111011101111111111111
                        11111110001111111111100000001
                           10000000001000000100N00001
                           10000000001000000100000001
                           10000000001000000100000001
                           10000000001100000000000001
                           10000000001000000100000001
                           10000000001000000100000001
                           11011111011000000100000001
                           11111111111111111111111111