NO assets/north_texture.png
SO assets/south_texture.png
WE assets/west_texture.png
EA assets/east_texture.png

C 36,28,45
F 42,44,60

1111111111111111111111111111111111111111111111111111111111111111
1000000000000000000000000000000000000000000000000110000000000001
1000000000000000000000000000000000000000000000000110110000000001
111111111111C111111111C111111111C11111111111111C1110110000000011
1000000000010100000001010000000101000000000010000010100001000011
1000001010000000101000000010100000001010000010000010000011100001
1000111C111000111C111000111C111000111C11100010000010100001000011
1000100000100010000010001000001000100000100010000010110000000011
10001000001000100000100010000010001000001000111110C0110000000001
1000100000100010000010001000001000100000100011111110000000000001
100010000010001000001000100000100010000010001000001111111C111111
1000100000100010000010001000001000100000100010000010000000000001
10001111111000111111100011111110001111111000100000C0000000000001
1100000000000000000000000000000000000000000110000010000000000001
1100000000000000000000000000000000000000000110000010000000000001
10001111111000111111100011111110001111111000111C1111111111111111
1000100000100010000010001000001000100000100010000010000000011001
1000100000100010000010001000001000100000100010000010000000011001
10001000001000100000100010000010001000001000100000C0000000000001
1000100000100010000010001000001000100000100010000010000000000001
1000100000100010000010001000001000100000100010000010000000000001
1000111C111000111C111000111C111000111C11100010000010000000000001
10000010100000001010000000101000000010100000100000C0000000000001
1000000000010100000001010000000101000000000010000010000000011001
111111111111C111111111C111111111C1111111111110000010000000011001
1000000000000000000000000000000000000000000010000011111111111111
1000000000000000000000000000000000000000000010000010000000000001
11111111111111111111111111111111111111111111100000C0000000000001
1000100000000000000000000000000011111111111110000010000000000001
1000C00000000000000000000000000010000000000111C11111100000000001
1000100000000000000000000000000010000000000110001111100000000001
10001111111111111111111111100111111100111C1110001000100000000001
1000100000000001100000000010010000010010000000001000100000000001
1100100000000000100000000011111000111110000000001000100000000001
1100100000000000C000000000100011C1100010000000001000110000000001
110010000000000010000000001000100010001000000000C00011C111111111
1000100000000001100000000111C1100011C110011111111111100011100111
1000111111C111111111111C1110000000000010010000000000100010000001
10000000000000100000010001100001110000100100000000001000C0000001
10000000000000C0000001000110001111100010010000000000100010000001
1000000000000010000001000110011010110011111C11111111100010000001
11C1111111111111111111000100010010010001000000000000000010000001
110000000000000010000C000C0001111111000C000000N000000000C0000001
1100000000000000100001000100011101110001000000000000000010000001
11100000000000001000011C1110001111100011111C11111110000010000001
1110000000000000100001000110001010100010000001100011100010000001
11111111111111111111110000100000000000100000011000001000C0000001
                     1000011C1100011C111110000000000100010000001
                     1000010001000100000010000000000100011111111
                     11111100011C110000001111111111111C111111111
                        1000001000100000010000000000000000000001
                        10000010001000000C0000000000000000000001
                        1000001000100000010000000000000000000001
                        1000001000100000011111C111C1111111111111
                        11111110001111111111100000001
                           10000000001000000100000001
                           10000000001000000100000001
                           10000000001000000100000001
                           10000000001100000C00000001
                           10000000001000000100000001
                           10000000001000000100000001
                           11011111011000000100000001
                           11111111111111111111111111