NO assets/north_texture.png
SO assets/south_texture.png
WE assets/west_texture.png
EA assets/east_texture.png

C 36,28,45
F 42,44,60

        1111111111111111111111111
        1000000000110000000000001
        1011000001110000000000001
        1001000000000000000000001
111111111011000001110000000000001
100000000011000001110111110111111
11110111111111011100000010001
11110111111111011101010010001
11000000110101011100000000001
10000000000000001100000010001
100000000000001101010010001111                                                                   
11000001110101011111011110N1                                                             
10010111 1110101101111010001
111111111 11111111 111111111111
