1111111111111
1101010101011
1N00000000001
1010101010101
1111111111111