NO assets/north_texture.png
SO assets/south_texture.png
WE assets/west_texture.png
EA assets/east_texture.png

C 36,28,45
F 42,44,60

1111111111111
1000000000001
100000W000001
1111110111111
1000000000001
1000000000001
1110111110111
1000001000001
1000001000001
1000000000001
1000001000001
1000001000001
1111111111111