NO assets/north_texture.png
SO assets/south_texture.png
WE assets/west_texture.png
EA assets/east_texture.png

C 36,28,45
F 42,44,60

1111111111111
100000S000001
1000000000001
111111C111111
1000000000001
1000000000001
111O11111C111
1000001000001
1000001000001
100000C000001
1000001000001
1000001000001
1111111111111